EA textures/gold.xpm
 WE textures/wood.xpm
   C 255,25,100
       SO textures/cobble.xpm
     NO textures/dirt.xpm

F 10,100,10

1111111
1010001
1010001
1011001
1000001
1000W01
1000001
1001001
1011011
1011111
1011111
1000001
1111101
1110001
1110111
1110111
1000001
1000001
1000001
1000001
1111111
